Country,iso_n3,1995,2005,2014,delta
Afghanistan,4,1243,1327,9809,8566
Albania,8,2087,4254,5717,3630
Algeria,12,95294,107278,145400,50106
Andorra,20,425,576,462,37
Angola,24,10975,19156,34763,23788
Anguilla,660,66,128,143,77
Antigua and Barbuda,28,275,429,532,257
Argentina,32,127964,162111,204025,76061
Armenia,51,3410,4353,5530,2120
Aruba,533,1668,2721,873,-795
Australia,36,281860,350173,361262,79402
Austria,40,59783,74216,58712,-1071
Azerbaijan,31,33333,34338,37488,4155
Bahamas,44,1683,1742,2417,734
Bahrain,48,14818,19208,31338,16520
Bangladesh,50,22816,39479,73190,50374
Barbados,52,829,1353,1272,443
Belarus,112,60773,59167,63498,2725
Belgium,56,112328,108510,93351,-18977
Belize,84,378,422,495,117
Benin,204,1327,2395,6318,4991
Bermuda,60,532,583,576,44
Bhutan,64,249,396,1001,752
Bolivia (Plurin. State of),68,9850,12185,20411,10561
Bosnia and Herzegovina,70,3429,16204,22233,18804
Botswana,72,3047,4096,7033,3986
Brazil,76,258347,347309,529808,271461
British Virgin Islands,92,84,132,180,96
Brunei Darussalam,96,4789,5005,9109,4320
Bulgaria,100,58005,47917,42416,-15589
Burkina Faso,854,627,1126,2849,2222
Burundi,108,238,154,440,202
Cabo Verde,132,121,440,491,370
Cambodia,116,1551,2776,6685,5134
Cameroon,120,4228,3696,7004,2776
Canada,124,467638,557417,537193,69555
Central African Republic,140,235,235,301,66
Chad,148,110,400,730,620
Chile,152,41745,61818,82563,40818
China,156,3320285,5896958,10291927,6971642
"China, Macao SAR",446,1232,1830,1283,51
Colombia,170,59614,60946,84092,24478
Comoros,174,73,139,154,81
Congo,178,1566,983,3095,1529
Cook Islands,184,40,62,70,30
Costa Rica,188,4866,6868,7759,2893
Croatia,191,16986,22592,16843,-143
Cuba,192,25709,26006,34837,9128
Cyprus,196,5383,7503,6062,679
Czechia,203,123831,120109,96475,-27356
Dem. People's Rep. Korea,408,82911,75573,40528,-42383
Dem. Rep. of the Congo,180,2123,1500,4672,2549
Denmark,208,57172,47095,33498,-23674
Djibouti,262,304,414,722,418
Dominica,212,81,117,136,55
Dominican Republic,214,15885,18639,21540,5655
Ecuador,218,22842,30264,43920,21078
Egypt,818,95723,167208,201894,106171
El Salvador,222,5027,6454,6285,1258
Equatorial Guinea,226,128,4712,5346,5218
Eritrea,232,935,766,697,-238
Estonia,233,17521,16755,19519,1998
Ethiopia,231,2563,5119,11599,9036
Falkland Islands (Malvinas),238,44,51,55,11
Faroe Islands,234,572,722,598,26
Fiji,242,763,1096,1170,407
Finland,246,52713,54646,47301,-5412
France,250,349161,385369,303276,-45885
French Guiana,254,583,554,733,150
French Polynesia,258,429,821,803,374
Gabon,266,4624,4888,5192,568
Gambia,270,198,293,513,315
Georgia,268,2303,5068,8988,6685
Germany,276,864110,797180,719883,-144227
Ghana,288,5277,6993,14466,9189
Greece,300,78782,98675,67319,-11463
Greenland,304,502,609,506,4
Grenada,308,150,216,242,92
Guadeloupe,312,1463,2222,2567,1104
Guatemala,320,7165,12570,18328,11163
Guinea,324,1291,1826,2450,1159
Guinea-Bissau,624,183,213,271,88
Guyana,328,1463,1437,2010,547
Haiti,332,902,2076,2860,1958
Honduras,340,3880,7554,9472,5592
Hungary,348,60370,58019,42086,-18284
Iceland,352,1947,2230,1984,37
India,356,811562,1222563,2238377,1426815
Indonesia,360,224941,341992,464176,239235
Iran (Islamic Republic of),364,272942,468808,649481,376539
Iraq,368,74348,113523,168444,94096
Ireland,372,32970,43538,34066,1096
Israel,376,51100,56952,64602,13502
Italy,380,430484,473384,320411,-110073
Jamaica,388,9179,10499,7422,-1757
Japan,392,1183447,1239255,1214048,30601
Jordan,400,13557,21060,26450,12893
Kazakhstan,398,169166,177329,248315,79149
Kenya,404,7554,8562,14287,6733
Kiribati,296,29,62,62,33
Kuwait,414,54822,71547,95408,40586
Kyrgyzstan,417,4529,5592,9608,5079
Lao People's Dem. Rep.,418,348,1404,1955,1607
Latvia,428,9443,7506,6975,-2468
Lebanon,422,13579,16208,24070,10491
Lesotho,426,1709,2013,2468,759
Liberia,430,326,726,935,609
Libya,434,46021,52108,56996,10975
Lithuania,440,16204,13902,12838,-3366
Luxembourg,442,8317,11547,9659,1342
Madagascar,450,1265,1742,3077,1812
Malawi,454,920,876,1276,356
Malaysia,458,121132,174487,242821,121689
Maldives,462,249,601,1335,1086
Mali,466,469,898,1412,943
Malta,470,2123,2699,2347,224
Marshall Islands,584,66,84,103,37
Martinique,474,1639,2204,2299,660
Mauritania,478,1074,1588,2710,1636
Mauritius,480,1830,3297,4228,2398
Mexico,484,332817,466362,480271,147454
Micronesia (Fed. States of),583,106,121,150,44
Mongolia,496,7921,8562,20840,12919
Morocco,504,30374,45771,59864,29490
Mozambique,508,1115,1822,8427,7312
Myanmar,104,6960,11599,21632,14672
Namibia,516,1632,2310,3755,2123
Nauru,520,106,62,48,-58
Nepal,524,2035,3084,8031,5996
Netherlands,528,178634,181480,167303,-11331
New Caledonia,540,2076,2824,4290,2214
New Zealand,554,27132,34140,34664,7532
Nicaragua,558,2780,4320,4862,2082
Niger,562,810,715,2127,1317
Nigeria,566,35841,106068,96281,60440
Niue,570,7,4,11,4
Norway,578,33439,42438,47627,14188
Oman,512,15896,29893,61169,45273
Pakistan,586,84484,136636,166298,81814
Panama,591,2985,6839,8801,5816
Papua New Guinea,598,2061,4386,6318,4257
Paraguay,600,3964,3832,5702,1738
Peru,604,23883,37136,61745,37862
Philippines,608,60711,74832,105654,44943
Poland,616,344214,302539,285740,-58474
Portugal,620,51870,65280,45053,-6817
Qatar,634,31789,50957,107854,76065
Republic of Korea,410,374771,462922,587156,212385
Republic of Moldova,498,11192,4895,4932,-6260
Romania,642,126049,96457,70003,-56046
Russian Federation,643,1631474,1615090,1705346,73872
Rwanda,646,462,528,840,378
Saint Helena,654,11,11,11,0
Saint Kitts and Nevis,659,128,198,231,103
Saint Lucia,662,312,367,407,95
Saint Pierre and Miquelon,666,70,66,77,7
Saint Vincent & Grenadines,670,128,220,209,81
Samoa,882,117,161,198,81
Sao Tome and Principe,678,48,77,114,66
Saudi Arabia,682,235161,397642,601047,365886
Senegal,686,3495,5812,8856,5361
Seychelles,690,198,689,495,297
Sierra Leone,694,400,546,1309,909
Singapore,702,42174,30359,56373,14199
Slovakia,703,42115,39358,30678,-11437
Slovenia,705,14404,15867,12812,-1592
Solomon Islands,90,143,161,202,59
Somalia,706,590,594,609,19
South Africa,710,362259,416916,489772,127513
Spain,724,241611,353462,233977,-7634
Sri Lanka,144,5904,12101,18394,12490
State of Palestine,275,946,2743,2838,1892
Suriname,740,2065,1595,1991,-74
Sweden,752,55155,51562,43421,-11734
Switzerland,756,39226,41338,35306,-3920
Syrian Arab Republic,760,41664,50627,30704,-10960
Tajikistan,762,2450,2442,5189,2739
Thailand,764,161154,247467,316213,155059
Togo,768,953,1338,2622,1669
Tonga,776,95,114,121,26
Trinidad and Tobago,780,17022,38151,46274,29252
Tunisia,788,15735,22662,28830,13095
Turkey,792,171975,237391,345981,174006
Turkmenistan,795,34000,48338,68423,34423
Turks and Caicos Islands,796,48,121,205,157
Uganda,800,939,2171,5229,4290
Ukraine,804,445944,333877,227299,-218645
United Arab Emirates,784,70641,116149,211370,140729
United Kingdom,826,538118,542580,419820,-118298
United Rep. of Tanzania,834,3553,5504,11562,8009
United States of America,840,5132920,5789727,5254279,121359
Uruguay,858,4591,5776,6747,2156
Uzbekistan,860,103435,117249,105214,1779
Vanuatu,548,66,59,154,88
Venezuela (Boliv. Rep. of),862,133350,165096,185220,51870
Viet Nam,704,29090,98144,166911,137821
Yemen,887,10466,20044,22699,12233
Zambia,894,2171,2288,4503,2332
Zimbabwe,716,15130,10770,12020,-3110
